#s###########
#.#.........#
#.#.#####.#.#
#.#.#.###.#.#
#......#..#.#
######e######
