################################################################
#........#........#............................................#
#..####..#..#######..############################..##########..#
#.....#.....#........#.....#.....#..............#.....#........#
####..#..####..#######..#..#..#..#..##########..####..#..#######
#.....#..#.....#........#.....#..#........#..#..#.....#.....#..#
#..####..#..####..###################..#######..##########..####
#..#.....#..#..#..#..............#..#..#.....#........#..#.....#
#..#######..####..#..##########..#..#..#..#..####..#..#######..#
#........#..#.....#.....#.....#..#..#.....#.....#..#...........#
#..####..#..#..#######..####..#..#############..#..#############
#..#.....#..#........#.....#..#..............#..#...........#..#
#..#..####..#############..#..#############..#..####..####..####
#..#..#....................#..............#..#.....#..#..#.....#
#..#..#..######################..#######..##.####..#..#..####..#
#..#........#.....#....................#..#.....#..#.....#.....#
#..#######..#..#..#..####..#######..#######..#..#..####..#..####
#..#........#..#..#.....#........#..#........#..#..#..#..#.....#
#..#..#######..#..####..#..##########..##########..#..#..####..#
#..#..#........#.....#..#.....#.....#...........#..#.....#..#..#
#..#..#..#############..####..#..#############..#..##########..#
#..#.......................#..#.....#..#..#.....#........#..#..#
#..#..############################..#######..##########..####..#
#..#........#.....#..#........#..#..#..#..............#..#.....#
##########..#..#..#..#..####..####..####..####..#######..#..####
#.....#.....#..#..#..#..#..#........#..#..#.....#.....#..#.....#
#..####..####..#..#..#..################..#..####..#..#..#######
#...........#..#..#..#.................#..#..#.....#..#........#
##########..####..#..################..#..#..################..#
s.................#.................#.....#..............#.....#
##########################################################e#####
