##############             ###############
#............#             #.............#
#s...........***************.............#           ############
#............#             #.............#           #..........#
##############             #.............#           #..........#        #################
                           #########*#####           #..........#        #...............#
                                    *                #..........#        #...............#
                                    *                #..........#        #...............#
                                    *           ******..........**********...............#
                                    *           *    #..........#        #...............#
                                    *           *    #..........#        #...............#
                               #####*####       *    #..........#        #...............#
#################              #........#       *    #..........#        #################
#...............#              #........#       *    #..........#
#...............#              #........#       *    ######*#####
#...............*******        #........#       *          *
#...............#     *        #####*####       *          *
#...............#     *             *           *          *
########*########     *             *           *          *
        *             *             *           *          *
        *             *             *           *          *
        *             *             *           *          *
        *             *             *           *      ####*###
        *             *             *           *      #......#            ###########
        *             *      #######*#######    *      #......#            #.........#
########*########     *      #.............#    *      #......#            #.........#
#...............#     *      #.............#    *      #......#            #.........#
#...............#     *      #.............#    *      #......**************.........#
#...............#     ********.............******      #......#            #......e..#
#...............#            #.............#           #......#            #.........#
#...............#            #.............#           #......#            #.........#
#...............#            ###############           #......#            ###########
#################                                      #......#
                                                       ########
