                    ###########
############        #.........#
#..........#        #.........#
#..........#        #.........#
#..........#        #.........#
#s.........**********.......e.#
#..........#        #.........#
#..........#        #.........#
############        #.........#
                    ###########
